11111111111
1PE00001001
10000000C01
11111111111
