111111111111111111111111111111
1PE0000000000000X000000000X001
101110000000000000000X00000X01
10000000000000000X000000000001
10C000000000000000000000000001
10000000000000X000C000000X0001
111111111111111111111111111111
